1111111111111111111111111111111111
1C0111111100001E00000C000000011001
1001003300111111111111111011111111
1001111111101010001001000000010101
10000000000C000000C000030000000101
1001111111101010001001000000010101
1P01111111101010001001000000010101
1111111111111111111111111111111111